"filename", "language", "Markdown", "Docker", "XML", "YAML", "Java", "comment", "blank", "total"
"c:\Users\syhie\IdeaProjects\onlinebiz\.github\workflows\build.yml", "YAML", 0, 0, 0, 14, 0, 0, 4, 18
"c:\Users\syhie\IdeaProjects\onlinebiz\.github\workflows\codeql-analysis.yml", "YAML", 0, 0, 0, 31, 0, 29, 13, 73
"c:\Users\syhie\IdeaProjects\onlinebiz\.github\workflows\test-coverage.yml", "YAML", 0, 0, 0, 20, 0, 0, 4, 24
"c:\Users\syhie\IdeaProjects\onlinebiz\.github\workflows\test_unit.yml", "YAML", 0, 0, 0, 14, 0, 0, 4, 18
"c:\Users\syhie\IdeaProjects\onlinebiz\README.md", "Markdown", 9, 0, 0, 0, 0, 0, 8, 17
"c:\Users\syhie\IdeaProjects\onlinebiz\SECURITY.md", "Markdown", 15, 0, 0, 0, 0, 0, 7, 22
"c:\Users\syhie\IdeaProjects\onlinebiz\onlinebiz-common\pom.xml", "XML", 0, 0, 18, 0, 0, 0, 5, 23
"c:\Users\syhie\IdeaProjects\onlinebiz\onlinebiz-common\src\main\java\com\njustc\onlinebiz\common\model\EntrustDto.java", "Java", 0, 0, 0, 0, 15, 6, 10, 31
"c:\Users\syhie\IdeaProjects\onlinebiz\onlinebiz-common\src\main\java\com\njustc\onlinebiz\common\model\PageResult.java", "Java", 0, 0, 0, 0, 14, 5, 9, 28
"c:\Users\syhie\IdeaProjects\onlinebiz\onlinebiz-common\src\main\java\com\njustc\onlinebiz\common\model\PartyDetail.java", "Java", 0, 0, 0, 0, 24, 16, 19, 59
"c:\Users\syhie\IdeaProjects\onlinebiz\onlinebiz-common\src\main\java\com\njustc\onlinebiz\common\model\Role.java", "Java", 0, 0, 0, 0, 11, 9, 11, 31
"c:\Users\syhie\IdeaProjects\onlinebiz\onlinebiz-common\src\main\java\com\njustc\onlinebiz\common\model\Software.java", "Java", 0, 0, 0, 0, 50, 32, 39, 121
"c:\Users\syhie\IdeaProjects\onlinebiz\onlinebiz-common\src\main\java\com\njustc\onlinebiz\common\model\UserDto.java", "Java", 0, 0, 0, 0, 13, 0, 8, 21
"c:\Users\syhie\IdeaProjects\onlinebiz\onlinebiz-common\src\main\java\com\njustc\onlinebiz\common\model\contract\Contract.java", "Java", 0, 0, 0, 0, 28, 19, 22, 69
"c:\Users\syhie\IdeaProjects\onlinebiz\onlinebiz-common\src\main\java\com\njustc\onlinebiz\common\model\contract\ContractStage.java", "Java", 0, 0, 0, 0, 11, 9, 11, 31
"c:\Users\syhie\IdeaProjects\onlinebiz\onlinebiz-common\src\main\java\com\njustc\onlinebiz\common\model\contract\ContractStatus.java", "Java", 0, 0, 0, 0, 11, 3, 6, 20
"c:\Users\syhie\IdeaProjects\onlinebiz\onlinebiz-common\src\main\java\com\njustc\onlinebiz\common\model\contract\NonDisclosureAgreement.java", "Java", 0, 0, 0, 0, 11, 2, 6, 19
"c:\Users\syhie\IdeaProjects\onlinebiz\onlinebiz-common\src\main\java\com\njustc\onlinebiz\common\model\entrust\Entrust.java", "Java", 0, 0, 0, 0, 39, 12, 16, 67
"c:\Users\syhie\IdeaProjects\onlinebiz\onlinebiz-common\src\main\java\com\njustc\onlinebiz\common\model\entrust\EntrustContent.java", "Java", 0, 0, 0, 0, 21, 10, 14, 45
"c:\Users\syhie\IdeaProjects\onlinebiz\onlinebiz-common\src\main\java\com\njustc\onlinebiz\common\model\entrust\EntrustOutline.java", "Java", 0, 0, 0, 0, 36, 10, 14, 60
"c:\Users\syhie\IdeaProjects\onlinebiz\onlinebiz-common\src\main\java\com\njustc\onlinebiz\common\model\entrust\EntrustQuote.java", "Java", 0, 0, 0, 0, 32, 19, 24, 75
"c:\Users\syhie\IdeaProjects\onlinebiz\onlinebiz-common\src\main\java\com\njustc\onlinebiz\common\model\entrust\EntrustReview.java", "Java", 0, 0, 0, 0, 16, 7, 11, 34
"c:\Users\syhie\IdeaProjects\onlinebiz\onlinebiz-common\src\main\java\com\njustc\onlinebiz\common\model\entrust\EntrustStage.java", "Java", 0, 0, 0, 0, 14, 12, 14, 40
"c:\Users\syhie\IdeaProjects\onlinebiz\onlinebiz-common\src\main\java\com\njustc\onlinebiz\common\model\entrust\EntrustStatus.java", "Java", 0, 0, 0, 0, 11, 2, 6, 19
"c:\Users\syhie\IdeaProjects\onlinebiz\onlinebiz-common\src\main\java\com\njustc\onlinebiz\common\model\entrust\SoftwareDocReview.java", "Java", 0, 0, 0, 0, 26, 12, 18, 56
"c:\Users\syhie\IdeaProjects\onlinebiz\onlinebiz-common\src\main\java\com\njustc\onlinebiz\common\model\sample\Sample.java", "Java", 0, 0, 0, 0, 16, 5, 3, 24
"c:\Users\syhie\IdeaProjects\onlinebiz\onlinebiz-common\src\main\java\com\njustc\onlinebiz\common\model\sample\SampleCollection.java", "Java", 0, 0, 0, 0, 18, 6, 4, 28
"c:\Users\syhie\IdeaProjects\onlinebiz\onlinebiz-common\src\main\java\com\njustc\onlinebiz\common\model\sample\SampleCollectionStage.java", "Java", 0, 0, 0, 0, 7, 5, 3, 15
"c:\Users\syhie\IdeaProjects\onlinebiz\onlinebiz-common\src\main\java\com\njustc\onlinebiz\common\model\test\project\Project.java", "Java", 0, 0, 0, 0, 16, 8, 7, 31
"c:\Users\syhie\IdeaProjects\onlinebiz\onlinebiz-common\src\main\java\com\njustc\onlinebiz\common\model\test\project\ProjectBaseInfo.java", "Java", 0, 0, 0, 0, 29, 8, 7, 44
"c:\Users\syhie\IdeaProjects\onlinebiz\onlinebiz-common\src\main\java\com\njustc\onlinebiz\common\model\test\project\ProjectFormIds.java", "Java", 0, 0, 0, 0, 19, 9, 5, 33
"c:\Users\syhie\IdeaProjects\onlinebiz\onlinebiz-common\src\main\java\com\njustc\onlinebiz\common\model\test\project\ProjectOutline.java", "Java", 0, 0, 0, 0, 25, 7, 6, 38
"c:\Users\syhie\IdeaProjects\onlinebiz\onlinebiz-common\src\main\java\com\njustc\onlinebiz\common\model\test\project\ProjectStage.java", "Java", 0, 0, 0, 0, 18, 19, 16, 53
"c:\Users\syhie\IdeaProjects\onlinebiz\onlinebiz-common\src\main\java\com\njustc\onlinebiz\common\model\test\project\ProjectStatus.java", "Java", 0, 0, 0, 0, 11, 2, 5, 18
"c:\Users\syhie\IdeaProjects\onlinebiz\onlinebiz-common\src\main\java\com\njustc\onlinebiz\common\model\test\report\Report.java", "Java", 0, 0, 0, 0, 64, 42, 8, 114
"c:\Users\syhie\IdeaProjects\onlinebiz\onlinebiz-common\src\main\java\com\njustc\onlinebiz\common\model\test\report\SoftwareEnvironment.java", "Java", 0, 0, 0, 0, 14, 3, 3, 20
"c:\Users\syhie\IdeaProjects\onlinebiz\onlinebiz-common\src\main\java\com\njustc\onlinebiz\common\model\test\report\TestContent.java", "Java", 0, 0, 0, 0, 14, 3, 3, 20
"c:\Users\syhie\IdeaProjects\onlinebiz\onlinebiz-common\src\main\java\com\njustc\onlinebiz\common\model\test\review\EntrustTestReview.java", "Java", 0, 0, 0, 0, 24, 13, 4, 41
"c:\Users\syhie\IdeaProjects\onlinebiz\onlinebiz-common\src\main\java\com\njustc\onlinebiz\common\model\test\review\ReportReview.java", "Java", 0, 0, 0, 0, 26, 12, 4, 42
"c:\Users\syhie\IdeaProjects\onlinebiz\onlinebiz-common\src\main\java\com\njustc\onlinebiz\common\model\test\review\SchemeReview.java", "Java", 0, 0, 0, 0, 28, 34, 11, 73
"c:\Users\syhie\IdeaProjects\onlinebiz\onlinebiz-common\src\main\java\com\njustc\onlinebiz\common\model\test\scheme\Modification.java", "Java", 0, 0, 0, 0, 18, 5, 4, 27
"c:\Users\syhie\IdeaProjects\onlinebiz\onlinebiz-common\src\main\java\com\njustc\onlinebiz\common\model\test\scheme\Schedule.java", "Java", 0, 0, 0, 0, 15, 3, 3, 21
"c:\Users\syhie\IdeaProjects\onlinebiz\onlinebiz-common\src\main\java\com\njustc\onlinebiz\common\model\test\scheme\Scheme.java", "Java", 0, 0, 0, 0, 17, 6, 10, 33
"c:\Users\syhie\IdeaProjects\onlinebiz\onlinebiz-common\src\main\java\com\njustc\onlinebiz\common\model\test\scheme\SchemeContent.java", "Java", 0, 0, 0, 0, 32, 22, 4, 58
"c:\Users\syhie\IdeaProjects\onlinebiz\onlinebiz-common\src\main\java\com\njustc\onlinebiz\common\model\test\testcase\Testcase.java", "Java", 0, 0, 0, 0, 27, 12, 15, 54
"c:\Users\syhie\IdeaProjects\onlinebiz\onlinebiz-common\src\main\java\com\njustc\onlinebiz\common\model\test\testissue\TestIssueList.java", "Java", 0, 0, 0, 0, 29, 14, 17, 60
"c:\Users\syhie\IdeaProjects\onlinebiz\onlinebiz-common\src\main\java\com\njustc\onlinebiz\common\model\test\testrecord\TestRecordList.java", "Java", 0, 0, 0, 0, 34, 19, 22, 75
"c:\Users\syhie\IdeaProjects\onlinebiz\onlinebiz-contract\pom.xml", "XML", 0, 0, 82, 0, 0, 0, 14, 96
"c:\Users\syhie\IdeaProjects\onlinebiz\onlinebiz-contract\src\main\java\com\njustc\onlinebiz\contract\ContractServiceApplication.java", "Java", 0, 0, 0, 0, 9, 0, 5, 14
"c:\Users\syhie\IdeaProjects\onlinebiz\onlinebiz-contract\src\main\java\com\njustc\onlinebiz\contract\configuration\ContractServiceConfiguration.java", "Java", 0, 0, 0, 0, 15, 0, 5, 20
"c:\Users\syhie\IdeaProjects\onlinebiz\onlinebiz-contract\src\main\java\com\njustc\onlinebiz\contract\controller\ContractController.java", "Java", 0, 0, 0, 0, 125, 12, 19, 156
"c:\Users\syhie\IdeaProjects\onlinebiz\onlinebiz-contract\src\main\java\com\njustc\onlinebiz\contract\controller\ContractControllerAdvice.java", "Java", 0, 0, 0, 0, 64, 0, 12, 76
"c:\Users\syhie\IdeaProjects\onlinebiz\onlinebiz-contract\src\main\java\com\njustc\onlinebiz\contract\dao\ContractDAO.java", "Java", 0, 0, 0, 0, 15, 54, 13, 82
"c:\Users\syhie\IdeaProjects\onlinebiz\onlinebiz-contract\src\main\java\com\njustc\onlinebiz\contract\dao\MongoContractDAO.java", "Java", 0, 0, 0, 0, 79, 4, 17, 100
"c:\Users\syhie\IdeaProjects\onlinebiz\onlinebiz-contract\src\main\java\com\njustc\onlinebiz\contract\exception\ContractCreateFailureException.java", "Java", 0, 0, 0, 0, 6, 0, 4, 10
"c:\Users\syhie\IdeaProjects\onlinebiz\onlinebiz-contract\src\main\java\com\njustc\onlinebiz\contract\exception\ContractDAOFailureException.java", "Java", 0, 0, 0, 0, 6, 0, 4, 10
"c:\Users\syhie\IdeaProjects\onlinebiz\onlinebiz-contract\src\main\java\com\njustc\onlinebiz\contract\exception\ContractInvalidStageException.java", "Java", 0, 0, 0, 0, 6, 0, 4, 10
"c:\Users\syhie\IdeaProjects\onlinebiz\onlinebiz-contract\src\main\java\com\njustc\onlinebiz\contract\exception\ContractNotFoundException.java", "Java", 0, 0, 0, 0, 6, 0, 4, 10
"c:\Users\syhie\IdeaProjects\onlinebiz\onlinebiz-contract\src\main\java\com\njustc\onlinebiz\contract\exception\ContractPermissionDeniedException.java", "Java", 0, 0, 0, 0, 6, 0, 4, 10
"c:\Users\syhie\IdeaProjects\onlinebiz\onlinebiz-contract\src\main\java\com\njustc\onlinebiz\contract\service\ContractService.java", "Java", 0, 0, 0, 0, 23, 95, 18, 136
"c:\Users\syhie\IdeaProjects\onlinebiz\onlinebiz-contract\src\main\java\com\njustc\onlinebiz\contract\service\DefaultContractService.java", "Java", 0, 0, 0, 0, 302, 25, 26, 353
"c:\Users\syhie\IdeaProjects\onlinebiz\onlinebiz-contract\src\main\resources\application-dev.yml", "YAML", 0, 0, 0, 4, 0, 0, 1, 5
"c:\Users\syhie\IdeaProjects\onlinebiz\onlinebiz-contract\src\main\resources\application-prod.yml", "YAML", 0, 0, 0, 4, 0, 0, 1, 5
"c:\Users\syhie\IdeaProjects\onlinebiz\onlinebiz-contract\src\main\resources\application.yml", "YAML", 0, 0, 0, 27, 0, 0, 3, 30
"c:\Users\syhie\IdeaProjects\onlinebiz\onlinebiz-contract\src\test\java\com\njustc\onlinebiz\contract\DefaultContractServiceTest.java", "Java", 0, 0, 0, 0, 299, 0, 54, 353
"c:\Users\syhie\IdeaProjects\onlinebiz\onlinebiz-contract\src\test\java\com\njustc\onlinebiz\contract\MongoContractDAOIT.java", "Java", 0, 0, 0, 0, 130, 0, 25, 155
"c:\Users\syhie\IdeaProjects\onlinebiz\onlinebiz-discovery\pom.xml", "XML", 0, 0, 26, 0, 0, 0, 6, 32
"c:\Users\syhie\IdeaProjects\onlinebiz\onlinebiz-discovery\src\main\java\com\njustc\onlinebiz\discovery\DiscoveryServiceApplication.java", "Java", 0, 0, 0, 0, 11, 0, 3, 14
"c:\Users\syhie\IdeaProjects\onlinebiz\onlinebiz-discovery\src\main\resources\application.yml", "YAML", 0, 0, 0, 14, 0, 1, 3, 18
"c:\Users\syhie\IdeaProjects\onlinebiz\onlinebiz-document\pom.xml", "XML", 0, 0, 109, 0, 0, 0, 18, 127
"c:\Users\syhie\IdeaProjects\onlinebiz\onlinebiz-document\src\main\java\com\njustc\onlinebiz\doc\DocumentServiceApplication.java", "Java", 0, 0, 0, 0, 9, 0, 3, 12
"c:\Users\syhie\IdeaProjects\onlinebiz\onlinebiz-document\src\main\java\com\njustc\onlinebiz\doc\configuration\DocConfig.java", "Java", 0, 0, 0, 0, 14, 0, 5, 19
"c:\Users\syhie\IdeaProjects\onlinebiz\onlinebiz-document\src\main\java\com\njustc\onlinebiz\doc\controller\DownloadController.java", "Java", 0, 0, 0, 0, 202, 121, 22, 345
"c:\Users\syhie\IdeaProjects\onlinebiz\onlinebiz-document\src\main\java\com\njustc\onlinebiz\doc\controller\DownloadControllerAdvice.java", "Java", 0, 0, 0, 0, 35, 22, 8, 65
"c:\Users\syhie\IdeaProjects\onlinebiz\onlinebiz-document\src\main\java\com\njustc\onlinebiz\doc\dao\OSSProvider.java", "Java", 0, 0, 0, 0, 40, 16, 7, 63
"c:\Users\syhie\IdeaProjects\onlinebiz\onlinebiz-document\src\main\java\com\njustc\onlinebiz\doc\exception\DownloadDAOFailureException.java", "Java", 0, 0, 0, 0, 6, 0, 3, 9
"c:\Users\syhie\IdeaProjects\onlinebiz\onlinebiz-document\src\main\java\com\njustc\onlinebiz\doc\exception\DownloadNotFoundException.java", "Java", 0, 0, 0, 0, 6, 0, 3, 9
"c:\Users\syhie\IdeaProjects\onlinebiz\onlinebiz-document\src\main\java\com\njustc\onlinebiz\doc\exception\DownloadPermissionDeniedException.java", "Java", 0, 0, 0, 0, 6, 0, 3, 9
"c:\Users\syhie\IdeaProjects\onlinebiz\onlinebiz-document\src\main\java\com\njustc\onlinebiz\doc\model\EntrustQuoteDoc.java", "Java", 0, 0, 0, 0, 47, 12, 6, 65
"c:\Users\syhie\IdeaProjects\onlinebiz\onlinebiz-document\src\main\java\com\njustc\onlinebiz\doc\model\JS002.java", "Java", 0, 0, 0, 0, 481, 20, 22, 523
"c:\Users\syhie\IdeaProjects\onlinebiz\onlinebiz-document\src\main\java\com\njustc\onlinebiz\doc\model\JS003\GongNeng.java", "Java", 0, 0, 0, 0, 35, 0, 7, 42
"c:\Users\syhie\IdeaProjects\onlinebiz\onlinebiz-document\src\main\java\com\njustc\onlinebiz\doc\model\JS003\JS003.java", "Java", 0, 0, 0, 0, 78, 2, 14, 94
"c:\Users\syhie\IdeaProjects\onlinebiz\onlinebiz-document\src\main\java\com\njustc\onlinebiz\doc\model\JS003\ZiGongNeng.java", "Java", 0, 0, 0, 0, 24, 0, 6, 30
"c:\Users\syhie\IdeaProjects\onlinebiz\onlinebiz-document\src\main\java\com\njustc\onlinebiz\doc\model\JS004.java", "Java", 0, 0, 0, 0, 111, 5, 12, 128
"c:\Users\syhie\IdeaProjects\onlinebiz\onlinebiz-document\src\main\java\com\njustc\onlinebiz\doc\model\JS005.java", "Java", 0, 0, 0, 0, 35, 2, 5, 42
"c:\Users\syhie\IdeaProjects\onlinebiz\onlinebiz-document\src\main\java\com\njustc\onlinebiz\doc\model\JS006.java", "Java", 0, 0, 0, 0, 131, 1, 5, 137
"c:\Users\syhie\IdeaProjects\onlinebiz\onlinebiz-document\src\main\java\com\njustc\onlinebiz\doc\model\JS007.java", "Java", 0, 0, 0, 0, 218, 3, 25, 246
"c:\Users\syhie\IdeaProjects\onlinebiz\onlinebiz-document\src\main\java\com\njustc\onlinebiz\doc\model\JS008.java", "Java", 0, 0, 0, 0, 25, 1, 7, 33
"c:\Users\syhie\IdeaProjects\onlinebiz\onlinebiz-document\src\main\java\com\njustc\onlinebiz\doc\model\JS009.java", "Java", 0, 0, 0, 0, 25, 1, 6, 32
"c:\Users\syhie\IdeaProjects\onlinebiz\onlinebiz-document\src\main\java\com\njustc\onlinebiz\doc\model\JS010.java", "Java", 0, 0, 0, 0, 59, 1, 6, 66
"c:\Users\syhie\IdeaProjects\onlinebiz\onlinebiz-document\src\main\java\com\njustc\onlinebiz\doc\model\JS011.java", "Java", 0, 0, 0, 0, 25, 1, 8, 34
"c:\Users\syhie\IdeaProjects\onlinebiz\onlinebiz-document\src\main\java\com\njustc\onlinebiz\doc\model\JS012.java", "Java", 0, 0, 0, 0, 104, 0, 8, 112
"c:\Users\syhie\IdeaProjects\onlinebiz\onlinebiz-document\src\main\java\com\njustc\onlinebiz\doc\model\JS013.java", "Java", 0, 0, 0, 0, 85, 1, 6, 92
"c:\Users\syhie\IdeaProjects\onlinebiz\onlinebiz-document\src\main\java\com\njustc\onlinebiz\doc\model\JS014.java", "Java", 0, 0, 0, 0, 180, 2, 12, 194
"c:\Users\syhie\IdeaProjects\onlinebiz\onlinebiz-document\src\main\java\com\njustc\onlinebiz\doc\service\DocServiceEntrustQuote.java", "Java", 0, 0, 0, 0, 179, 20, 30, 229
"c:\Users\syhie\IdeaProjects\onlinebiz\onlinebiz-document\src\main\java\com\njustc\onlinebiz\doc\service\DocServiceJS001.java", "Java", 0, 0, 0, 0, 123, 21, 20, 164
"c:\Users\syhie\IdeaProjects\onlinebiz\onlinebiz-document\src\main\java\com\njustc\onlinebiz\doc\service\DocServiceJS002.java", "Java", 0, 0, 0, 0, 440, 28, 44, 512
"c:\Users\syhie\IdeaProjects\onlinebiz\onlinebiz-document\src\main\java\com\njustc\onlinebiz\doc\service\DocServiceJS003.java", "Java", 0, 0, 0, 0, 128, 31, 22, 181
"c:\Users\syhie\IdeaProjects\onlinebiz\onlinebiz-document\src\main\java\com\njustc\onlinebiz\doc\service\DocServiceJS004.java", "Java", 0, 0, 0, 0, 638, 38, 60, 736
"c:\Users\syhie\IdeaProjects\onlinebiz\onlinebiz-document\src\main\java\com\njustc\onlinebiz\doc\service\DocServiceJS005.java", "Java", 0, 0, 0, 0, 135, 24, 19, 178
"c:\Users\syhie\IdeaProjects\onlinebiz\onlinebiz-document\src\main\java\com\njustc\onlinebiz\doc\service\DocServiceJS006.java", "Java", 0, 0, 0, 0, 379, 80, 68, 527
"c:\Users\syhie\IdeaProjects\onlinebiz\onlinebiz-document\src\main\java\com\njustc\onlinebiz\doc\service\DocServiceJS007.java", "Java", 0, 0, 0, 0, 470, 48, 79, 597
"c:\Users\syhie\IdeaProjects\onlinebiz\onlinebiz-document\src\main\java\com\njustc\onlinebiz\doc\service\DocServiceJS008.java", "Java", 0, 0, 0, 0, 120, 24, 24, 168
"c:\Users\syhie\IdeaProjects\onlinebiz\onlinebiz-document\src\main\java\com\njustc\onlinebiz\doc\service\DocServiceJS009.java", "Java", 0, 0, 0, 0, 133, 24, 22, 179
"c:\Users\syhie\IdeaProjects\onlinebiz\onlinebiz-document\src\main\java\com\njustc\onlinebiz\doc\service\DocServiceJS010.java", "Java", 0, 0, 0, 0, 196, 29, 36, 261
"c:\Users\syhie\IdeaProjects\onlinebiz\onlinebiz-document\src\main\java\com\njustc\onlinebiz\doc\service\DocServiceJS011.java", "Java", 0, 0, 0, 0, 121, 23, 22, 166
"c:\Users\syhie\IdeaProjects\onlinebiz\onlinebiz-document\src\main\java\com\njustc\onlinebiz\doc\service\DocServiceJS012.java", "Java", 0, 0, 0, 0, 305, 34, 35, 374
"c:\Users\syhie\IdeaProjects\onlinebiz\onlinebiz-document\src\main\java\com\njustc\onlinebiz\doc\service\DocServiceJS013.java", "Java", 0, 0, 0, 0, 168, 29, 34, 231
"c:\Users\syhie\IdeaProjects\onlinebiz\onlinebiz-document\src\main\java\com\njustc\onlinebiz\doc\service\DocServiceJS014.java", "Java", 0, 0, 0, 0, 285, 30, 40, 355
"c:\Users\syhie\IdeaProjects\onlinebiz\onlinebiz-document\src\main\java\com\njustc\onlinebiz\doc\service\RestRequestService.java", "Java", 0, 0, 0, 0, 206, 75, 26, 307
"c:\Users\syhie\IdeaProjects\onlinebiz\onlinebiz-document\src\main\java\com\njustc\onlinebiz\doc\util\HeaderFooter.java", "Java", 0, 0, 0, 0, 92, 10, 8, 110
"c:\Users\syhie\IdeaProjects\onlinebiz\onlinebiz-document\src\main\java\com\njustc\onlinebiz\doc\util\ItextUtils.java", "Java", 0, 0, 0, 0, 410, 182, 23, 615
"c:\Users\syhie\IdeaProjects\onlinebiz\onlinebiz-document\src\main\resources\application.yml", "YAML", 0, 0, 0, 14, 0, 3, 3, 20
"c:\Users\syhie\IdeaProjects\onlinebiz\onlinebiz-document\src\test\java\com\njustc\onlinebiz\doc\EntrustQuoteDocTest.java", "Java", 0, 0, 0, 0, 34, 0, 6, 40
"c:\Users\syhie\IdeaProjects\onlinebiz\onlinebiz-document\src\test\java\com\njustc\onlinebiz\doc\JS001Test.java", "Java", 0, 0, 0, 0, 16, 0, 5, 21
"c:\Users\syhie\IdeaProjects\onlinebiz\onlinebiz-document\src\test\java\com\njustc\onlinebiz\doc\JS002Test.java", "Java", 0, 0, 0, 0, 157, 2, 8, 167
"c:\Users\syhie\IdeaProjects\onlinebiz\onlinebiz-document\src\test\java\com\njustc\onlinebiz\doc\JS003Test.java", "Java", 0, 0, 0, 0, 48, 0, 11, 59
"c:\Users\syhie\IdeaProjects\onlinebiz\onlinebiz-document\src\test\java\com\njustc\onlinebiz\doc\JS004Test.java", "Java", 0, 0, 0, 0, 53, 0, 7, 60
"c:\Users\syhie\IdeaProjects\onlinebiz\onlinebiz-document\src\test\java\com\njustc\onlinebiz\doc\JS005Test.java", "Java", 0, 0, 0, 0, 20, 0, 7, 27
"c:\Users\syhie\IdeaProjects\onlinebiz\onlinebiz-document\src\test\java\com\njustc\onlinebiz\doc\JS006Test.java", "Java", 0, 0, 0, 0, 54, 0, 5, 59
"c:\Users\syhie\IdeaProjects\onlinebiz\onlinebiz-document\src\test\java\com\njustc\onlinebiz\doc\JS007Test.java", "Java", 0, 0, 0, 0, 102, 0, 12, 114
"c:\Users\syhie\IdeaProjects\onlinebiz\onlinebiz-document\src\test\java\com\njustc\onlinebiz\doc\JS008Test.java", "Java", 0, 0, 0, 0, 28, 0, 7, 35
"c:\Users\syhie\IdeaProjects\onlinebiz\onlinebiz-document\src\test\java\com\njustc\onlinebiz\doc\JS009Test.java", "Java", 0, 0, 0, 0, 26, 0, 6, 32
"c:\Users\syhie\IdeaProjects\onlinebiz\onlinebiz-document\src\test\java\com\njustc\onlinebiz\doc\JS010Test.java", "Java", 0, 0, 0, 0, 32, 0, 6, 38
"c:\Users\syhie\IdeaProjects\onlinebiz\onlinebiz-document\src\test\java\com\njustc\onlinebiz\doc\JS011Test.java", "Java", 0, 0, 0, 0, 29, 0, 7, 36
"c:\Users\syhie\IdeaProjects\onlinebiz\onlinebiz-document\src\test\java\com\njustc\onlinebiz\doc\JS012Test.java", "Java", 0, 0, 0, 0, 53, 0, 10, 63
"c:\Users\syhie\IdeaProjects\onlinebiz\onlinebiz-document\src\test\java\com\njustc\onlinebiz\doc\JS013Test.java", "Java", 0, 0, 0, 0, 36, 0, 6, 42
"c:\Users\syhie\IdeaProjects\onlinebiz\onlinebiz-document\src\test\java\com\njustc\onlinebiz\doc\JS014Test.java", "Java", 0, 0, 0, 0, 91, 0, 7, 98
"c:\Users\syhie\IdeaProjects\onlinebiz\onlinebiz-document\src\test\java\com\njustc\onlinebiz\doc\RestRequestTest.java", "Java", 0, 0, 0, 0, 151, 32, 15, 198
"c:\Users\syhie\IdeaProjects\onlinebiz\onlinebiz-document\src\test\java\com\njustc\onlinebiz\doc\dao\OSSProviderTest.java", "Java", 0, 0, 0, 0, 50, 6, 5, 61
"c:\Users\syhie\IdeaProjects\onlinebiz\onlinebiz-document\src\test\resources\application.yml", "YAML", 0, 0, 0, 6, 0, 0, 2, 8
"c:\Users\syhie\IdeaProjects\onlinebiz\onlinebiz-entrust\pom.xml", "XML", 0, 0, 82, 0, 0, 1, 13, 96
"c:\Users\syhie\IdeaProjects\onlinebiz\onlinebiz-entrust\src\main\java\com\njustc\onlinebiz\entrust\EntrustServiceApplication.java", "Java", 0, 0, 0, 0, 11, 0, 6, 17
"c:\Users\syhie\IdeaProjects\onlinebiz\onlinebiz-entrust\src\main\java\com\njustc\onlinebiz\entrust\controller\EntrustController.java", "Java", 0, 0, 0, 0, 192, 24, 28, 244
"c:\Users\syhie\IdeaProjects\onlinebiz\onlinebiz-entrust\src\main\java\com\njustc\onlinebiz\entrust\controller\EntrustControllerAdvice.java", "Java", 0, 0, 0, 0, 39, 0, 9, 48
"c:\Users\syhie\IdeaProjects\onlinebiz\onlinebiz-entrust\src\main\java\com\njustc\onlinebiz\entrust\dao\EntrustDAO.java", "Java", 0, 0, 0, 0, 26, 123, 25, 174
"c:\Users\syhie\IdeaProjects\onlinebiz\onlinebiz-entrust\src\main\java\com\njustc\onlinebiz\entrust\dao\MongoEntrustDAO.java", "Java", 0, 0, 0, 0, 144, 9, 32, 185
"c:\Users\syhie\IdeaProjects\onlinebiz\onlinebiz-entrust\src\main\java\com\njustc\onlinebiz\entrust\exception\EntrustDAOFailureException.java", "Java", 0, 0, 0, 0, 6, 0, 4, 10
"c:\Users\syhie\IdeaProjects\onlinebiz\onlinebiz-entrust\src\main\java\com\njustc\onlinebiz\entrust\exception\EntrustInvalidArgumentException.java", "Java", 0, 0, 0, 0, 6, 0, 4, 10
"c:\Users\syhie\IdeaProjects\onlinebiz\onlinebiz-entrust\src\main\java\com\njustc\onlinebiz\entrust\exception\EntrustInvalidStageException.java", "Java", 0, 0, 0, 0, 6, 0, 4, 10
"c:\Users\syhie\IdeaProjects\onlinebiz\onlinebiz-entrust\src\main\java\com\njustc\onlinebiz\entrust\exception\EntrustNotFoundException.java", "Java", 0, 0, 0, 0, 6, 0, 4, 10
"c:\Users\syhie\IdeaProjects\onlinebiz\onlinebiz-entrust\src\main\java\com\njustc\onlinebiz\entrust\exception\EntrustPermissionDeniedException.java", "Java", 0, 0, 0, 0, 6, 0, 4, 10
"c:\Users\syhie\IdeaProjects\onlinebiz\onlinebiz-entrust\src\main\java\com\njustc\onlinebiz\entrust\service\DefaultEntrustService.java", "Java", 0, 0, 0, 0, 350, 33, 31, 414
"c:\Users\syhie\IdeaProjects\onlinebiz\onlinebiz-entrust\src\main\java\com\njustc\onlinebiz\entrust\service\EntrustService.java", "Java", 0, 0, 0, 0, 27, 163, 26, 216
"c:\Users\syhie\IdeaProjects\onlinebiz\onlinebiz-entrust\src\main\resources\application-dev.yml", "YAML", 0, 0, 0, 4, 0, 0, 1, 5
"c:\Users\syhie\IdeaProjects\onlinebiz\onlinebiz-entrust\src\main\resources\application-prod.yml", "YAML", 0, 0, 0, 4, 0, 0, 1, 5
"c:\Users\syhie\IdeaProjects\onlinebiz\onlinebiz-entrust\src\main\resources\application.yml", "YAML", 0, 0, 0, 22, 0, 0, 3, 25
"c:\Users\syhie\IdeaProjects\onlinebiz\onlinebiz-entrust\src\test\java\com\njustc\onlinebiz\entrust\DefaultEntrustServiceTest.java", "Java", 0, 0, 0, 0, 526, 13, 83, 622
"c:\Users\syhie\IdeaProjects\onlinebiz\onlinebiz-entrust\src\test\java\com\njustc\onlinebiz\entrust\MongoEntrustDAOIT.java", "Java", 0, 0, 0, 0, 317, 9, 48, 374
"c:\Users\syhie\IdeaProjects\onlinebiz\onlinebiz-gateway\Dockerfile", "Docker", 0, 3, 0, 0, 0, 0, 3, 6
"c:\Users\syhie\IdeaProjects\onlinebiz\onlinebiz-gateway\pom.xml", "XML", 0, 0, 34, 0, 0, 0, 7, 41
"c:\Users\syhie\IdeaProjects\onlinebiz\onlinebiz-gateway\src\main\java\com\njustc\onlinebiz\gateway\GatewayServiceApplication.java", "Java", 0, 0, 0, 0, 13, 0, 5, 18
"c:\Users\syhie\IdeaProjects\onlinebiz\onlinebiz-gateway\src\main\java\com\njustc\onlinebiz\gateway\filter\AddIdentityGatewayFilterFactory.java", "Java", 0, 0, 0, 0, 89, 12, 15, 116
"c:\Users\syhie\IdeaProjects\onlinebiz\onlinebiz-gateway\src\main\resources\application-dev.yml", "YAML", 0, 0, 0, 0, 0, 0, 1, 1
"c:\Users\syhie\IdeaProjects\onlinebiz\onlinebiz-gateway\src\main\resources\application-prod.yml", "YAML", 0, 0, 0, 0, 0, 0, 1, 1
"c:\Users\syhie\IdeaProjects\onlinebiz\onlinebiz-gateway\src\main\resources\application.yml", "YAML", 0, 0, 0, 90, 0, 2, 10, 102
"c:\Users\syhie\IdeaProjects\onlinebiz\onlinebiz-sample\pom.xml", "XML", 0, 0, 82, 0, 0, 0, 14, 96
"c:\Users\syhie\IdeaProjects\onlinebiz\onlinebiz-sample\src\main\java\com\njustc\onlinebiz\sample\SampleServiceApplication.java", "Java", 0, 0, 0, 0, 9, 0, 3, 12
"c:\Users\syhie\IdeaProjects\onlinebiz\onlinebiz-sample\src\main\java\com\njustc\onlinebiz\sample\configuration\SampleServiceConfiguration.java", "Java", 0, 0, 0, 0, 13, 0, 5, 18
"c:\Users\syhie\IdeaProjects\onlinebiz\onlinebiz-sample\src\main\java\com\njustc\onlinebiz\sample\controller\SampleController.java", "Java", 0, 0, 0, 0, 45, 4, 9, 58
"c:\Users\syhie\IdeaProjects\onlinebiz\onlinebiz-sample\src\main\java\com\njustc\onlinebiz\sample\controller\SampleControllerAdvice.java", "Java", 0, 0, 0, 0, 47, 0, 8, 55
"c:\Users\syhie\IdeaProjects\onlinebiz\onlinebiz-sample\src\main\java\com\njustc\onlinebiz\sample\dao\MongoSampleDAO.java", "Java", 0, 0, 0, 0, 69, 3, 16, 88
"c:\Users\syhie\IdeaProjects\onlinebiz\onlinebiz-sample\src\main\java\com\njustc\onlinebiz\sample\dao\SampleDAO.java", "Java", 0, 0, 0, 0, 11, 29, 10, 50
"c:\Users\syhie\IdeaProjects\onlinebiz\onlinebiz-sample\src\main\java\com\njustc\onlinebiz\sample\exception\SampleDAOFailureException.java", "Java", 0, 0, 0, 0, 4, 0, 3, 7
"c:\Users\syhie\IdeaProjects\onlinebiz\onlinebiz-sample\src\main\java\com\njustc\onlinebiz\sample\exception\SampleInvalidArgumentException.java", "Java", 0, 0, 0, 0, 4, 0, 3, 7
"c:\Users\syhie\IdeaProjects\onlinebiz\onlinebiz-sample\src\main\java\com\njustc\onlinebiz\sample\exception\SampleInvalidStageException.java", "Java", 0, 0, 0, 0, 4, 0, 3, 7
"c:\Users\syhie\IdeaProjects\onlinebiz\onlinebiz-sample\src\main\java\com\njustc\onlinebiz\sample\exception\SampleNotFoundException.java", "Java", 0, 0, 0, 0, 4, 0, 3, 7
"c:\Users\syhie\IdeaProjects\onlinebiz\onlinebiz-sample\src\main\java\com\njustc\onlinebiz\sample\exception\SamplePermissionDeniedException.java", "Java", 0, 0, 0, 0, 4, 0, 3, 7
"c:\Users\syhie\IdeaProjects\onlinebiz\onlinebiz-sample\src\main\java\com\njustc\onlinebiz\sample\service\DefaultSampleService.java", "Java", 0, 0, 0, 0, 92, 12, 11, 115
"c:\Users\syhie\IdeaProjects\onlinebiz\onlinebiz-sample\src\main\java\com\njustc\onlinebiz\sample\service\SampleService.java", "Java", 0, 0, 0, 0, 10, 29, 11, 50
"c:\Users\syhie\IdeaProjects\onlinebiz\onlinebiz-sample\src\main\resources\application-dev.yml", "YAML", 0, 0, 0, 4, 0, 0, 1, 5
"c:\Users\syhie\IdeaProjects\onlinebiz\onlinebiz-sample\src\main\resources\application-prod.yml", "YAML", 0, 0, 0, 4, 0, 0, 1, 5
"c:\Users\syhie\IdeaProjects\onlinebiz\onlinebiz-sample\src\main\resources\application.yml", "YAML", 0, 0, 0, 22, 0, 0, 3, 25
"c:\Users\syhie\IdeaProjects\onlinebiz\onlinebiz-sample\src\test\java\com\njustc\onlinebiz\sample\DefaultSampleServiceTest.java", "Java", 0, 0, 0, 0, 84, 16, 13, 113
"c:\Users\syhie\IdeaProjects\onlinebiz\onlinebiz-sample\src\test\java\com\njustc\onlinebiz\sample\MongoSampleDAOIT.java", "Java", 0, 0, 0, 0, 101, 3, 17, 121
"c:\Users\syhie\IdeaProjects\onlinebiz\onlinebiz-test\pom.xml", "XML", 0, 0, 87, 0, 0, 0, 12, 99
"c:\Users\syhie\IdeaProjects\onlinebiz\onlinebiz-test\src\main\java\com\njustc\onlinebiz\test\TestServiceApplication.java", "Java", 0, 0, 0, 0, 9, 0, 5, 14
"c:\Users\syhie\IdeaProjects\onlinebiz\onlinebiz-test\src\main\java\com\njustc\onlinebiz\test\config\TestConfig.java", "Java", 0, 0, 0, 0, 15, 0, 3, 18
"c:\Users\syhie\IdeaProjects\onlinebiz\onlinebiz-test\src\main\java\com\njustc\onlinebiz\test\controller\project\ProjectController.java", "Java", 0, 0, 0, 0, 69, 52, 12, 133
"c:\Users\syhie\IdeaProjects\onlinebiz\onlinebiz-test\src\main\java\com\njustc\onlinebiz\test\controller\project\ProjectControllerAdvice.java", "Java", 0, 0, 0, 0, 53, 36, 14, 103
"c:\Users\syhie\IdeaProjects\onlinebiz\onlinebiz-test\src\main\java\com\njustc\onlinebiz\test\controller\report\ReportController.java", "Java", 0, 0, 0, 0, 37, 27, 7, 71
"c:\Users\syhie\IdeaProjects\onlinebiz\onlinebiz-test\src\main\java\com\njustc\onlinebiz\test\controller\report\ReportControllerAdvice.java", "Java", 0, 0, 0, 0, 55, 29, 8, 92
"c:\Users\syhie\IdeaProjects\onlinebiz\onlinebiz-test\src\main\java\com\njustc\onlinebiz\test\controller\review\EntrustTestReviewController.java", "Java", 0, 0, 0, 0, 29, 20, 6, 55
"c:\Users\syhie\IdeaProjects\onlinebiz\onlinebiz-test\src\main\java\com\njustc\onlinebiz\test\controller\review\ReportReviewController.java", "Java", 0, 0, 0, 0, 53, 38, 9, 100
"c:\Users\syhie\IdeaProjects\onlinebiz\onlinebiz-test\src\main\java\com\njustc\onlinebiz\test\controller\review\ReviewControllerAdvice.java", "Java", 0, 0, 0, 0, 51, 34, 10, 95
"c:\Users\syhie\IdeaProjects\onlinebiz\onlinebiz-test\src\main\java\com\njustc\onlinebiz\test\controller\review\SchemeReviewController.java", "Java", 0, 0, 0, 0, 54, 40, 11, 105
"c:\Users\syhie\IdeaProjects\onlinebiz\onlinebiz-test\src\main\java\com\njustc\onlinebiz\test\controller\scheme\SchemeController.java", "Java", 0, 0, 0, 0, 40, 27, 8, 75
"c:\Users\syhie\IdeaProjects\onlinebiz\onlinebiz-test\src\main\java\com\njustc\onlinebiz\test\controller\scheme\SchemeControllerAdvice.java", "Java", 0, 0, 0, 0, 43, 28, 6, 77
"c:\Users\syhie\IdeaProjects\onlinebiz\onlinebiz-test\src\main\java\com\njustc\onlinebiz\test\controller\testcase\TestcaseController.java", "Java", 0, 0, 0, 0, 40, 27, 8, 75
"c:\Users\syhie\IdeaProjects\onlinebiz\onlinebiz-test\src\main\java\com\njustc\onlinebiz\test\controller\testcase\TestcaseControllerAdvice.java", "Java", 0, 0, 0, 0, 51, 34, 9, 94
"c:\Users\syhie\IdeaProjects\onlinebiz\onlinebiz-test\src\main\java\com\njustc\onlinebiz\test\controller\testissue\TestIssueController.java", "Java", 0, 0, 0, 0, 40, 27, 8, 75
"c:\Users\syhie\IdeaProjects\onlinebiz\onlinebiz-test\src\main\java\com\njustc\onlinebiz\test\controller\testissue\TestIssueControllerAdvice.java", "Java", 0, 0, 0, 0, 51, 34, 9, 94
"c:\Users\syhie\IdeaProjects\onlinebiz\onlinebiz-test\src\main\java\com\njustc\onlinebiz\test\controller\testrecord\TestRecordController.java", "Java", 0, 0, 0, 0, 40, 27, 8, 75
"c:\Users\syhie\IdeaProjects\onlinebiz\onlinebiz-test\src\main\java\com\njustc\onlinebiz\test\controller\testrecord\TestRecordControllerAdvice.java", "Java", 0, 0, 0, 0, 51, 34, 9, 94
"c:\Users\syhie\IdeaProjects\onlinebiz\onlinebiz-test\src\main\java\com\njustc\onlinebiz\test\dao\project\MongoProjectDAO.java", "Java", 0, 0, 0, 0, 112, 10, 24, 146
"c:\Users\syhie\IdeaProjects\onlinebiz\onlinebiz-test\src\main\java\com\njustc\onlinebiz\test\dao\project\ProjectDAO.java", "Java", 0, 0, 0, 0, 22, 81, 19, 122
"c:\Users\syhie\IdeaProjects\onlinebiz\onlinebiz-test\src\main\java\com\njustc\onlinebiz\test\dao\report\MongoReportDAO.java", "Java", 0, 0, 0, 0, 42, 0, 9, 51
"c:\Users\syhie\IdeaProjects\onlinebiz\onlinebiz-test\src\main\java\com\njustc\onlinebiz\test\dao\report\ReportDAO.java", "Java", 0, 0, 0, 0, 8, 29, 6, 43
"c:\Users\syhie\IdeaProjects\onlinebiz\onlinebiz-test\src\main\java\com\njustc\onlinebiz\test\dao\review\EntrustTestReviewDAO.java", "Java", 0, 0, 0, 0, 8, 21, 6, 35
"c:\Users\syhie\IdeaProjects\onlinebiz\onlinebiz-test\src\main\java\com\njustc\onlinebiz\test\dao\review\MongoEntrustTestReviewDAO.java", "Java", 0, 0, 0, 0, 50, 1, 8, 59
"c:\Users\syhie\IdeaProjects\onlinebiz\onlinebiz-test\src\main\java\com\njustc\onlinebiz\test\dao\review\MongoReportReviewDAO.java", "Java", 0, 0, 0, 0, 50, 1, 10, 61
"c:\Users\syhie\IdeaProjects\onlinebiz\onlinebiz-test\src\main\java\com\njustc\onlinebiz\test\dao\review\MongoSchemeReviewDAO.java", "Java", 0, 0, 0, 0, 50, 1, 10, 61
"c:\Users\syhie\IdeaProjects\onlinebiz\onlinebiz-test\src\main\java\com\njustc\onlinebiz\test\dao\review\ReportReviewDAO.java", "Java", 0, 0, 0, 0, 9, 26, 7, 42
"c:\Users\syhie\IdeaProjects\onlinebiz\onlinebiz-test\src\main\java\com\njustc\onlinebiz\test\dao\review\SchemeReviewDAO.java", "Java", 0, 0, 0, 0, 9, 29, 10, 48
"c:\Users\syhie\IdeaProjects\onlinebiz\onlinebiz-test\src\main\java\com\njustc\onlinebiz\test\dao\scheme\MongoSchemeDAO.java", "Java", 0, 0, 0, 0, 43, 1, 10, 54
"c:\Users\syhie\IdeaProjects\onlinebiz\onlinebiz-test\src\main\java\com\njustc\onlinebiz\test\dao\scheme\SchemeDAO.java", "Java", 0, 0, 0, 0, 9, 30, 6, 45
"c:\Users\syhie\IdeaProjects\onlinebiz\onlinebiz-test\src\main\java\com\njustc\onlinebiz\test\dao\testcase\MongoTestcaseDAO.java", "Java", 0, 0, 0, 0, 43, 1, 11, 55
"c:\Users\syhie\IdeaProjects\onlinebiz\onlinebiz-test\src\main\java\com\njustc\onlinebiz\test\dao\testcase\TestcaseDAO.java", "Java", 0, 0, 0, 0, 9, 29, 7, 45
"c:\Users\syhie\IdeaProjects\onlinebiz\onlinebiz-test\src\main\java\com\njustc\onlinebiz\test\dao\testissue\MongoTestIssueDAO.java", "Java", 0, 0, 0, 0, 43, 1, 12, 56
"c:\Users\syhie\IdeaProjects\onlinebiz\onlinebiz-test\src\main\java\com\njustc\onlinebiz\test\dao\testissue\TestIssueDAO.java", "Java", 0, 0, 0, 0, 9, 29, 7, 45
"c:\Users\syhie\IdeaProjects\onlinebiz\onlinebiz-test\src\main\java\com\njustc\onlinebiz\test\dao\testrecord\MongoTestRecordDAO.java", "Java", 0, 0, 0, 0, 43, 1, 12, 56
"c:\Users\syhie\IdeaProjects\onlinebiz\onlinebiz-test\src\main\java\com\njustc\onlinebiz\test\dao\testrecord\TestRecordDAO.java", "Java", 0, 0, 0, 0, 9, 29, 7, 45
"c:\Users\syhie\IdeaProjects\onlinebiz\onlinebiz-test\src\main\java\com\njustc\onlinebiz\test\exception\project\ProjectDAOFailureException.java", "Java", 0, 0, 0, 0, 6, 0, 2, 8
"c:\Users\syhie\IdeaProjects\onlinebiz\onlinebiz-test\src\main\java\com\njustc\onlinebiz\test\exception\project\ProjectInvalidArgumentException.java", "Java", 0, 0, 0, 0, 6, 0, 3, 9
"c:\Users\syhie\IdeaProjects\onlinebiz\onlinebiz-test\src\main\java\com\njustc\onlinebiz\test\exception\project\ProjectInvalidStageException.java", "Java", 0, 0, 0, 0, 6, 0, 2, 8
"c:\Users\syhie\IdeaProjects\onlinebiz\onlinebiz-test\src\main\java\com\njustc\onlinebiz\test\exception\project\ProjectNotFoundException.java", "Java", 0, 0, 0, 0, 6, 0, 2, 8
"c:\Users\syhie\IdeaProjects\onlinebiz\onlinebiz-test\src\main\java\com\njustc\onlinebiz\test\exception\project\ProjectPermissionDeniedException.java", "Java", 0, 0, 0, 0, 6, 0, 2, 8
"c:\Users\syhie\IdeaProjects\onlinebiz\onlinebiz-test\src\main\java\com\njustc\onlinebiz\test\exception\report\ReportDAOFailureException.java", "Java", 0, 0, 0, 0, 6, 0, 2, 8
"c:\Users\syhie\IdeaProjects\onlinebiz\onlinebiz-test\src\main\java\com\njustc\onlinebiz\test\exception\report\ReportInvalidStageException.java", "Java", 0, 0, 0, 0, 6, 0, 2, 8
"c:\Users\syhie\IdeaProjects\onlinebiz\onlinebiz-test\src\main\java\com\njustc\onlinebiz\test\exception\report\ReportNotFoundException.java", "Java", 0, 0, 0, 0, 6, 0, 2, 8
"c:\Users\syhie\IdeaProjects\onlinebiz\onlinebiz-test\src\main\java\com\njustc\onlinebiz\test\exception\report\ReportPermissionDeniedException.java", "Java", 0, 0, 0, 0, 6, 0, 2, 8
"c:\Users\syhie\IdeaProjects\onlinebiz\onlinebiz-test\src\main\java\com\njustc\onlinebiz\test\exception\review\ReviewDAOFailureException.java", "Java", 0, 0, 0, 0, 4, 0, 2, 6
"c:\Users\syhie\IdeaProjects\onlinebiz\onlinebiz-test\src\main\java\com\njustc\onlinebiz\test\exception\review\ReviewInvalidStageException.java", "Java", 0, 0, 0, 0, 4, 0, 2, 6
"c:\Users\syhie\IdeaProjects\onlinebiz\onlinebiz-test\src\main\java\com\njustc\onlinebiz\test\exception\review\ReviewNotFoundException.java", "Java", 0, 0, 0, 0, 4, 0, 2, 6
"c:\Users\syhie\IdeaProjects\onlinebiz\onlinebiz-test\src\main\java\com\njustc\onlinebiz\test\exception\review\ReviewPermissionDeniedException.java", "Java", 0, 0, 0, 0, 4, 0, 2, 6
"c:\Users\syhie\IdeaProjects\onlinebiz\onlinebiz-test\src\main\java\com\njustc\onlinebiz\test\exception\scheme\SchemeDAOFailureException.java", "Java", 0, 0, 0, 0, 6, 0, 2, 8
"c:\Users\syhie\IdeaProjects\onlinebiz\onlinebiz-test\src\main\java\com\njustc\onlinebiz\test\exception\scheme\SchemeInvalidStageException.java", "Java", 0, 0, 0, 0, 6, 0, 2, 8
"c:\Users\syhie\IdeaProjects\onlinebiz\onlinebiz-test\src\main\java\com\njustc\onlinebiz\test\exception\scheme\SchemeNotFoundException.java", "Java", 0, 0, 0, 0, 6, 0, 2, 8
"c:\Users\syhie\IdeaProjects\onlinebiz\onlinebiz-test\src\main\java\com\njustc\onlinebiz\test\exception\scheme\SchemePermissionDeniedException.java", "Java", 0, 0, 0, 0, 6, 0, 2, 8
"c:\Users\syhie\IdeaProjects\onlinebiz\onlinebiz-test\src\main\java\com\njustc\onlinebiz\test\exception\testcase\TestcaseDAOFailureException.java", "Java", 0, 0, 0, 0, 6, 0, 2, 8
"c:\Users\syhie\IdeaProjects\onlinebiz\onlinebiz-test\src\main\java\com\njustc\onlinebiz\test\exception\testcase\TestcaseInvalidStageException.java", "Java", 0, 0, 0, 0, 6, 0, 1, 7
"c:\Users\syhie\IdeaProjects\onlinebiz\onlinebiz-test\src\main\java\com\njustc\onlinebiz\test\exception\testcase\TestcaseNotFoundException.java", "Java", 0, 0, 0, 0, 6, 0, 2, 8
"c:\Users\syhie\IdeaProjects\onlinebiz\onlinebiz-test\src\main\java\com\njustc\onlinebiz\test\exception\testcase\TestcasePermissionDeniedException.java", "Java", 0, 0, 0, 0, 6, 0, 2, 8
"c:\Users\syhie\IdeaProjects\onlinebiz\onlinebiz-test\src\main\java\com\njustc\onlinebiz\test\exception\testissue\TestIssueDAOFailureException.java", "Java", 0, 0, 0, 0, 6, 0, 2, 8
"c:\Users\syhie\IdeaProjects\onlinebiz\onlinebiz-test\src\main\java\com\njustc\onlinebiz\test\exception\testissue\TestIssueInvalidStageException.java", "Java", 0, 0, 0, 0, 6, 0, 1, 7
"c:\Users\syhie\IdeaProjects\onlinebiz\onlinebiz-test\src\main\java\com\njustc\onlinebiz\test\exception\testissue\TestIssueNotFoundException.java", "Java", 0, 0, 0, 0, 6, 0, 2, 8
"c:\Users\syhie\IdeaProjects\onlinebiz\onlinebiz-test\src\main\java\com\njustc\onlinebiz\test\exception\testissue\TestIssuePermissionDeniedException.java", "Java", 0, 0, 0, 0, 6, 0, 2, 8
"c:\Users\syhie\IdeaProjects\onlinebiz\onlinebiz-test\src\main\java\com\njustc\onlinebiz\test\exception\testrecord\TestRecordDAOFailureException.java", "Java", 0, 0, 0, 0, 6, 0, 2, 8
"c:\Users\syhie\IdeaProjects\onlinebiz\onlinebiz-test\src\main\java\com\njustc\onlinebiz\test\exception\testrecord\TestRecordInvalidStageException.java", "Java", 0, 0, 0, 0, 6, 0, 1, 7
"c:\Users\syhie\IdeaProjects\onlinebiz\onlinebiz-test\src\main\java\com\njustc\onlinebiz\test\exception\testrecord\TestRecordNotFoundException.java", "Java", 0, 0, 0, 0, 6, 0, 2, 8
"c:\Users\syhie\IdeaProjects\onlinebiz\onlinebiz-test\src\main\java\com\njustc\onlinebiz\test\exception\testrecord\TestRecordPermissionDeniedException.java", "Java", 0, 0, 0, 0, 6, 0, 3, 9
"c:\Users\syhie\IdeaProjects\onlinebiz\onlinebiz-test\src\main\java\com\njustc\onlinebiz\test\service\project\MongoProjectService.java", "Java", 0, 0, 0, 0, 293, 34, 25, 352
"c:\Users\syhie\IdeaProjects\onlinebiz\onlinebiz-test\src\main\java\com\njustc\onlinebiz\test\service\project\ProjectService.java", "Java", 0, 0, 0, 0, 14, 58, 10, 82
"c:\Users\syhie\IdeaProjects\onlinebiz\onlinebiz-test\src\main\java\com\njustc\onlinebiz\test\service\report\MongoReportService.java", "Java", 0, 0, 0, 0, 115, 3, 15, 133
"c:\Users\syhie\IdeaProjects\onlinebiz\onlinebiz-test\src\main\java\com\njustc\onlinebiz\test\service\report\ReportService.java", "Java", 0, 0, 0, 0, 9, 37, 6, 52
"c:\Users\syhie\IdeaProjects\onlinebiz\onlinebiz-test\src\main\java\com\njustc\onlinebiz\test\service\review\EntrustTestReviewService.java", "Java", 0, 0, 0, 0, 12, 32, 7, 51
"c:\Users\syhie\IdeaProjects\onlinebiz\onlinebiz-test\src\main\java\com\njustc\onlinebiz\test\service\review\MongoEntrustTestReviewService.java", "Java", 0, 0, 0, 0, 64, 1, 10, 75
"c:\Users\syhie\IdeaProjects\onlinebiz\onlinebiz-test\src\main\java\com\njustc\onlinebiz\test\service\review\MongoReportReviewService.java", "Java", 0, 0, 0, 0, 160, 16, 22, 198
"c:\Users\syhie\IdeaProjects\onlinebiz\onlinebiz-test\src\main\java\com\njustc\onlinebiz\test\service\review\MongoSchemeReviewService.java", "Java", 0, 0, 0, 0, 183, 21, 16, 220
"c:\Users\syhie\IdeaProjects\onlinebiz\onlinebiz-test\src\main\java\com\njustc\onlinebiz\test\service\review\ReportReviewService.java", "Java", 0, 0, 0, 0, 15, 54, 11, 80
"c:\Users\syhie\IdeaProjects\onlinebiz\onlinebiz-test\src\main\java\com\njustc\onlinebiz\test\service\review\SchemeReviewService.java", "Java", 0, 0, 0, 0, 15, 54, 13, 82
"c:\Users\syhie\IdeaProjects\onlinebiz\onlinebiz-test\src\main\java\com\njustc\onlinebiz\test\service\scheme\MongoSchemeService.java", "Java", 0, 0, 0, 0, 103, 3, 18, 124
"c:\Users\syhie\IdeaProjects\onlinebiz\onlinebiz-test\src\main\java\com\njustc\onlinebiz\test\service\scheme\SchemeService.java", "Java", 0, 0, 0, 0, 10, 37, 11, 58
"c:\Users\syhie\IdeaProjects\onlinebiz\onlinebiz-test\src\main\java\com\njustc\onlinebiz\test\service\testcase\MongoTestcaseService.java", "Java", 0, 0, 0, 0, 109, 3, 16, 128
"c:\Users\syhie\IdeaProjects\onlinebiz\onlinebiz-test\src\main\java\com\njustc\onlinebiz\test\service\testcase\TestcaseService.java", "Java", 0, 0, 0, 0, 10, 37, 8, 55
"c:\Users\syhie\IdeaProjects\onlinebiz\onlinebiz-test\src\main\java\com\njustc\onlinebiz\test\service\testissue\MongoTestIssueService.java", "Java", 0, 0, 0, 0, 108, 3, 16, 127
"c:\Users\syhie\IdeaProjects\onlinebiz\onlinebiz-test\src\main\java\com\njustc\onlinebiz\test\service\testissue\TestIssueService.java", "Java", 0, 0, 0, 0, 10, 37, 8, 55
"c:\Users\syhie\IdeaProjects\onlinebiz\onlinebiz-test\src\main\java\com\njustc\onlinebiz\test\service\testrecord\MongoTestRecordService.java", "Java", 0, 0, 0, 0, 108, 3, 16, 127
"c:\Users\syhie\IdeaProjects\onlinebiz\onlinebiz-test\src\main\java\com\njustc\onlinebiz\test\service\testrecord\TestRecordService.java", "Java", 0, 0, 0, 0, 10, 37, 8, 55
"c:\Users\syhie\IdeaProjects\onlinebiz\onlinebiz-test\src\main\resources\application-dev.yml", "YAML", 0, 0, 0, 4, 0, 0, 2, 6
"c:\Users\syhie\IdeaProjects\onlinebiz\onlinebiz-test\src\main\resources\application-prod.yml", "YAML", 0, 0, 0, 4, 0, 0, 1, 5
"c:\Users\syhie\IdeaProjects\onlinebiz\onlinebiz-test\src\main\resources\application.yml", "YAML", 0, 0, 0, 27, 0, 0, 2, 29
"c:\Users\syhie\IdeaProjects\onlinebiz\onlinebiz-test\src\test\java\com\njustc\onlinebiz\test\TestServiceApplicationTests.java", "Java", 0, 0, 0, 0, 9, 0, 5, 14
"c:\Users\syhie\IdeaProjects\onlinebiz\onlinebiz-test\src\test\java\com\njustc\onlinebiz\test\dao\project\MongoProjectDAOIT.java", "Java", 0, 0, 0, 0, 225, 24, 30, 279
"c:\Users\syhie\IdeaProjects\onlinebiz\onlinebiz-test\src\test\java\com\njustc\onlinebiz\test\dao\report\MongoReportDAOIT.java", "Java", 0, 0, 0, 0, 82, 7, 12, 101
"c:\Users\syhie\IdeaProjects\onlinebiz\onlinebiz-test\src\test\java\com\njustc\onlinebiz\test\dao\review\MongoEntrustTestReviewDAOIT.java", "Java", 0, 0, 0, 0, 81, 8, 12, 101
"c:\Users\syhie\IdeaProjects\onlinebiz\onlinebiz-test\src\test\java\com\njustc\onlinebiz\test\dao\review\MongoReportReviewDAOIT.java", "Java", 0, 0, 0, 0, 87, 11, 15, 113
"c:\Users\syhie\IdeaProjects\onlinebiz\onlinebiz-test\src\test\java\com\njustc\onlinebiz\test\dao\review\MongoSchemeReviewDAOIT.java", "Java", 0, 0, 0, 0, 87, 11, 15, 113
"c:\Users\syhie\IdeaProjects\onlinebiz\onlinebiz-test\src\test\java\com\njustc\onlinebiz\test\dao\scheme\MongoSchemeDAOIT.java", "Java", 0, 0, 0, 0, 79, 9, 13, 101
"c:\Users\syhie\IdeaProjects\onlinebiz\onlinebiz-test\src\test\java\com\njustc\onlinebiz\test\dao\testcase\MongoTestcaseDAOIT.java", "Java", 0, 0, 0, 0, 80, 9, 13, 102
"c:\Users\syhie\IdeaProjects\onlinebiz\onlinebiz-test\src\test\java\com\njustc\onlinebiz\test\dao\testissue\MongoTestIssueDAOIT.java", "Java", 0, 0, 0, 0, 89, 9, 13, 111
"c:\Users\syhie\IdeaProjects\onlinebiz\onlinebiz-test\src\test\java\com\njustc\onlinebiz\test\dao\testrecord\MongoTestRecordDAOIT.java", "Java", 0, 0, 0, 0, 76, 9, 13, 98
"c:\Users\syhie\IdeaProjects\onlinebiz\onlinebiz-test\src\test\java\com\njustc\onlinebiz\test\service\project\MongoProjectServiceTest.java", "Java", 0, 0, 0, 0, 623, 0, 55, 678
"c:\Users\syhie\IdeaProjects\onlinebiz\onlinebiz-test\src\test\java\com\njustc\onlinebiz\test\service\report\MongoReportServiceTest.java", "Java", 0, 0, 0, 0, 323, 0, 30, 353
"c:\Users\syhie\IdeaProjects\onlinebiz\onlinebiz-test\src\test\java\com\njustc\onlinebiz\test\service\review\MongoEntrustTestReviewServiceTest.java", "Java", 0, 0, 0, 0, 159, 0, 20, 179
"c:\Users\syhie\IdeaProjects\onlinebiz\onlinebiz-test\src\test\java\com\njustc\onlinebiz\test\service\review\MongoReportReviewServiceTest.java", "Java", 0, 0, 0, 0, 351, 0, 29, 380
"c:\Users\syhie\IdeaProjects\onlinebiz\onlinebiz-test\src\test\java\com\njustc\onlinebiz\test\service\review\MongoSchemeReviewServiceTest.java", "Java", 0, 0, 0, 0, 562, 89, 43, 694
"c:\Users\syhie\IdeaProjects\onlinebiz\onlinebiz-test\src\test\java\com\njustc\onlinebiz\test\service\scheme\MongoSchemeServiceTest.java", "Java", 0, 0, 0, 0, 377, 67, 29, 473
"c:\Users\syhie\IdeaProjects\onlinebiz\onlinebiz-test\src\test\java\com\njustc\onlinebiz\test\service\testcase\MongoTestcaseServiceTest.java", "Java", 0, 0, 0, 0, 329, 56, 30, 415
"c:\Users\syhie\IdeaProjects\onlinebiz\onlinebiz-test\src\test\java\com\njustc\onlinebiz\test\service\testissue\MongoTestIssueServiceTest.java", "Java", 0, 0, 0, 0, 311, 57, 32, 400
"c:\Users\syhie\IdeaProjects\onlinebiz\onlinebiz-test\src\test\java\com\njustc\onlinebiz\test\service\testrecord\MongoTestRecordServiceTest.java", "Java", 0, 0, 0, 0, 305, 58, 27, 390
"c:\Users\syhie\IdeaProjects\onlinebiz\onlinebiz-user\Dockerfile", "Docker", 0, 3, 0, 0, 0, 0, 3, 6
"c:\Users\syhie\IdeaProjects\onlinebiz\onlinebiz-user\pom.xml", "XML", 0, 0, 104, 0, 0, 4, 18, 126
"c:\Users\syhie\IdeaProjects\onlinebiz\onlinebiz-user\src\main\java\com\njustc\onlinebiz\user\UserServiceApplication.java", "Java", 0, 0, 0, 0, 15, 0, 5, 20
"c:\Users\syhie\IdeaProjects\onlinebiz\onlinebiz-user\src\main\java\com\njustc\onlinebiz\user\controller\UserController.java", "Java", 0, 0, 0, 0, 95, 12, 17, 124
"c:\Users\syhie\IdeaProjects\onlinebiz\onlinebiz-user\src\main\java\com\njustc\onlinebiz\user\controller\UserControllerAdvice.java", "Java", 0, 0, 0, 0, 31, 0, 7, 38
"c:\Users\syhie\IdeaProjects\onlinebiz\onlinebiz-user\src\main\java\com\njustc\onlinebiz\user\exception\UserDBFailureException.java", "Java", 0, 0, 0, 0, 6, 0, 4, 10
"c:\Users\syhie\IdeaProjects\onlinebiz\onlinebiz-user\src\main\java\com\njustc\onlinebiz\user\exception\UserInvalidArgumentException.java", "Java", 0, 0, 0, 0, 6, 0, 4, 10
"c:\Users\syhie\IdeaProjects\onlinebiz\onlinebiz-user\src\main\java\com\njustc\onlinebiz\user\exception\UserPermissonDeniedException.java", "Java", 0, 0, 0, 0, 6, 0, 4, 10
"c:\Users\syhie\IdeaProjects\onlinebiz\onlinebiz-user\src\main\java\com\njustc\onlinebiz\user\mapper\UserMapper.java", "Java", 0, 0, 0, 0, 17, 52, 14, 83
"c:\Users\syhie\IdeaProjects\onlinebiz\onlinebiz-user\src\main\java\com\njustc\onlinebiz\user\model\User.java", "Java", 0, 0, 0, 0, 28, 0, 11, 39
"c:\Users\syhie\IdeaProjects\onlinebiz\onlinebiz-user\src\main\java\com\njustc\onlinebiz\user\service\DefaultUserService.java", "Java", 0, 0, 0, 0, 184, 36, 23, 243
"c:\Users\syhie\IdeaProjects\onlinebiz\onlinebiz-user\src\main\java\com\njustc\onlinebiz\user\service\UserService.java", "Java", 0, 0, 0, 0, 18, 59, 16, 93
"c:\Users\syhie\IdeaProjects\onlinebiz\onlinebiz-user\src\main\java\com\njustc\onlinebiz\user\service\UserServiceConfiguration.java", "Java", 0, 0, 0, 0, 44, 3, 8, 55
"c:\Users\syhie\IdeaProjects\onlinebiz\onlinebiz-user\src\main\resources\application-dev.yml", "YAML", 0, 0, 0, 6, 0, 0, 1, 7
"c:\Users\syhie\IdeaProjects\onlinebiz\onlinebiz-user\src\main\resources\application-prod.yml", "YAML", 0, 0, 0, 6, 0, 0, 1, 7
"c:\Users\syhie\IdeaProjects\onlinebiz\onlinebiz-user\src\main\resources\application.yml", "YAML", 0, 0, 0, 45, 0, 0, 4, 49
"c:\Users\syhie\IdeaProjects\onlinebiz\onlinebiz-user\src\main\resources\mappers\UserMapper.xml", "XML", 0, 0, 37, 0, 0, 0, 10, 47
"c:\Users\syhie\IdeaProjects\onlinebiz\onlinebiz-user\src\test\java\com\njustc\onlinebiz\user\UserControllerIT.java", "Java", 0, 0, 0, 0, 363, 10, 55, 428
"c:\Users\syhie\IdeaProjects\onlinebiz\onlinebiz-user\src\test\java\com\njustc\onlinebiz\user\UserMapperIT.java", "Java", 0, 0, 0, 0, 108, 3, 25, 136
"c:\Users\syhie\IdeaProjects\onlinebiz\pom.xml", "XML", 0, 0, 77, 0, 0, 4, 12, 93
"Total", "-", 24, 6, 738, 390, 19759, 4062, 3510, 28489